# -----------------------------------------
# Syntax coloring for TM1638plus library
# -----------------------------------------

# Datatypes (such as objects)
TM1638plus	KEYWORD1
TM1638plus_Model2	KEYWORD1
TM1638plus_Model3	KEYWORD1
TM1637plus_ModelX	KEYWORD1
MAX7219plus_Model6	KEYWORD1

# Methods / functions
displayBegin	KEYWORD2
reset	KEYWORD2
brightness	KEYWORD2
DisplayDecNumNibble	KEYWORD2

readButtons	KEYWORD2
setLED	KEYWORD2
setLEDs KEYWORD2
displayText	KEYWORD2
displayASCII	KEYWORD2
display7Seg	KEYWORD2
displayHex	KEYWORD2
displayIntNum	KEYWORD2

DisplaySegments	KEYWORD2
DisplayHexNum	KEYWORD2
DisplayDecNum	KEYWORD2
DisplayStr	KEYWORD2
ASCIItoSegment	KEYWORD2
ReadKey16	KEYWORD2
ReadKey16Two	KEYWORD2

displayBegin	KEYWORD2
displayClose	KEYWORD2
displayClear	KEYWORD2
setBrightness	KEYWORD2
setSegments	KEYWORD2
DisplayDecimal	KEYWORD2
DisplayDecimalwDot	KEYWORD2
DisplayString	KEYWORD2
encodeCharacter	KEYWORD2

InitDisplay	KEYWORD2
ClearDisplay	KEYWORD2
SetBrightness	KEYWORD2
DisplayTestMode	KEYWORD2
ShutdownMode	KEYWORD2
GetCommDelay	KEYWORD2
SetCommDelay	KEYWORD2
GetHardwareSPI	KEYWORD2
GetCurrentDisplayNumber	KEYWORD2
SetCurrentDisplayNumber	KEYWORD2
DisplayChar	KEYWORD2
DisplayText	KEYWORD2
DisplayIntNum	KEYWORD2
DisplayDecNumNibble	KEYWORD2
DisplayBCDChar	KEYWORD2
DisplayBCDText	KEYWORD2
SetSegment	KEYWORD2

# Constants
TMAlignTextRight	LITERAL1
TMAlignTextLeft	LITERAL1
DecPointOn	LITERAL1
DecPointOff	LITERAL1

